OOOOOOOO
OOOTOOOO
OSOOOTGO
OOOOOOOO
OOOOOOOO
OOOOOOGO
OOOOOTOT
OOOOGOOG